0222222222
2222222222
1111111111
2222222222
0022222222